11111111111111111111111111
10000000000000000000000001
100000000000000000p0000001
10000000000000000000000001
10000000111110000001010101
10000000100010000001010101
10000000100010000001010101
10000000100010000001010101
10000000110110000001010101
10000000000000000000000001
10000000000000000000000001
10000000000000001110000001
10000000000000010001000001
10000000000000010001000001
10000000000000010001000001
10000000000011110001111001
10000000000111000000011101
10000000000001111001110001
10000000000000000000000001
10000000000000000000000001
10000000000000000000000001
10000000000000000000000001
10000000101010101000000001
10000000010101010100000001
10000000101010101000000001
11111111111111111111111111