111111
100001
100101
100101
111111